1111111111111111111111111111111
0000000000100010000000001000001
1011111110111011101111101011101
1010000000001000100010001000101
1010111111101110111010111110101
1010101000101010001010000000101
1010101011101011101011111111101
1010101000001000001010001000101
1110101111101110111010101010101
1000100010000010100010101010001
1010111010111110101111101011111
1010001010100000101010001000101
1011111011101111101010111110101
1000000000001000001010000000101
1111111011111011111011101111101
1000000000001010001010001000001
1011111011101010101010111011101
1010001000101010100010000010001
1011101110101010111111101111101
1000001010100010001000101000001
1111111010101111101010101011111
1000000000100000001010101000001
1011111011101010111010111111101
1010000010001010100010000000001
1010111111111110101011111111111
1010000010000000101010001000001
1011111010111111101110111011101
1010001010000000100010001000101
1010111011111110101011101111101
1010000010000000101000000000000
1111111111111111111111111111111
